NO ./textures/ancient/north.xpm
SO ./textures/ancient/south.xpm
WE ./textures/ancient/west.xpm
EA ./textures/ancient/east.xpm
F 249,246,238
C 135,206,235
        1111111111111111111111111
        1000000000110000000000001
        1011000001110000000000001
        1001000000000000000000001
111111111011000001110000000000001
100000000011000001110111111111111
11110111101111011100000010001
11110111111111011101010010001
11000000110101011100000010001
10000000000000001100000010001
10000000000000001101010000001
11000001110101011111011110S01
11110111 1110101 101111110001
11111111 1111111 111111111110
