NO ./textures/ancient/north.xpm


SO ./textures/ancient/south.xpm


WE ./textures/ancient/west.xpm


EA ./textures/ancient/east.xpm

F 249,246,238

C 135,206,235



        11111111111111111111111111111111111111111111111111111111111111111111111111111111111111111111111111111111111111111111111111111111111111111111111111111111111111111111111111111111111111111
        10000000001100000000000011111111111111111111111111111111111111111111111111111111111111111111111111111111111111111111111111111111111111111111111111111111111111111111111111111111111111111
        10110000011100000000000011111111111111111111111111111111111111111111111111111111111111111111111111111111111111111111111111111111111111111111111111111111111111111111111111111111111111111
        10010000000000000000000011111111111111111111111111111111111111111111111111111111111111111111111111111111111111111111111111111111111111111111111111111111111111111111111111111111111111111
1111111110110000011100000000000011111111111111111111111111111111111111111111111111111111111111111111111111111111111111111111111111111111111111111111111111111111111111111111111111111111111111111
1000000000110000011101111111111111111111111111111111111111111111111111111111111111111111111111111111111111111111111111111111111111111111111111111111111111111111111111111111111111111111111111111
111101111011110111000000100011111111111111111111111111111111111111111111111111111111111111111111111111111111111111111111111111111111111111111111111111111111111111111111111111111111111111111
111101111111110111010100100000000000000000000000000000000000000000000000000000000000000000000000000001111
111101111111110111010100100000000000000000000000000000000000000000000000000000000000000000000000000001111
111101111111110111010100100000000000000000000000000000000000000000000000000000000000000000000000000001111
111101111111110111010100100000000000000000000000000000000000000000000000000000000000000000000000000001111
111101111111110111010100100000000000000000000000000000000000000000000000000000000000000000000000000001111
111101111111110111010100100000000000000000000000000000000000000000000000000000000000000000000000000001111
111101111111110111010100100000000000000000000000000000000000000000000000000000000000000000000000000001111
111101111111110111010100100000000000000000000000000000000000000000000000000000000000000000000000000001111
111101111111110111010100100000000000000000000000000000000000000000000000000000000000000000000000000001111
111101111111110111010100100000000000000000000000000000000000000000000000000000000000000000000000000001111
111101111111110111010100100000000000000000000000000000000000000000000000000000000000000000000000000001111
111101111111110111010100100000000000000000000000000000000000000000000000000000000000000000000000000001111
111101111111110111010100100000000000000000000000000000000000000000000000000000000000000000000000000001111
111101111111110111010100100000000000000000000000000000000000000000000000000000000000000000000000000001111
111101111111110111010100100000000000000000000000000000000000000000000000000000000000000000000000000001111
111101111111110111010100100000000000000000000000000000000000000000000000000000000000000000000000000001111
111101111111110111010100100000000000000000000000000000000000000000000000000000000000000000000000000001111
111101111111110111010100100000000000000000000000000000000000000000000000000000000000000000000000000001111
111101111111110111010100100000000000000000000000000000000000000000000000000000000000000000000000000001111
111101111111110111010100100000000000000000000000000000000000000000000000000000000000000000000000000001111
111101111111110111010100100000000000000000000000000000000000000000000000000000000000000000000000000001111
111101111111110111010100100000000000000000000000000000000000000000000000000000000000000000000000000001111
111101111111110111010100100000000000000000000000000000000000000000000000000000000000000000000000000001111
111101111111110111010100100000000000000000000000000000000000000000000000000000000000000000000000000001111
111101111111110111010100100000000000000000000000000000000000000000000000000000000000000000000000000001111
111101111111110000000000000000000000000000000000000000000000000000000000000000000000000000000000000001111
111101111111110111010100100000000000000000000000000000000000000000000000000000000000000000000000000001111
111101111111110111010100100000000000000000000000000000000000000000000000000000000000000000000000000001111
111101111111110111010100100000000000000000000000000000000000000000000000000000000000000000000000000001111
111101111111110111010100100000000000000000000000000000000000000000000000000000000000000000000000000001111
111101111111110111010100100000000000000000000000000000000000000000000000000000000000000000000000000001111
111101111111110111010100100000000000000000000000000000000000000000000000000000000000000000000000000001111
111101111111110111010100100000000000000000000000000000000000000000000000000000000000000000000000000001111
111101111111110111010100100000000000000000000000000000000000000000000000000000000000000000000000000001111
111101111111110111010100100000000000000000000000000000000000000000000000000000000000000000000000000001111
111101111111110111010100100000000000000000000000000000000000000000000000000000000000000000000000000001111
111101111111110111010100100000000000000000000000000000000000000000000000000000000000000000000000000001111
111101111111110111010100100000000000000000000000000000000000000000000000000000000000000000000000000001111
111101111111110111010100100000000000000000000000000000000000000000000000000000000000000000000000000001111
111101111111110111010100100000000000000000000000000000000000000000000000000000000000000000000000000001111
110000001101010111000000100011111111111111111111111111111111111111111111111111111111111111111111111111111111111111111111111111111111111111111111111111111111111111111111111111111111111111111
100000000000000011000000100011111111111111111111111111111111111111111111111111111111111111111111111111111111111111111111111111111111111111111111111111111111111111111111111111111111111111111
100000000000000011010100000011111111111111111111111111111111111111111111111111111111111111111111111111111111111111111111111111111111111111111111111111111111111111111111111111111111111111111
1100000111010101111101111N0011111111111111111111111111111111111111111111111111111111111111111111111111111111111111111111111111111111111111111111111111111111111111111111111111111111111111111
11110111 1110101 1011111100011111111111111111111111111111111111111111111111111111111111111111111111111111111111111111111111111111111111111111111111111111111111111111111111111111111111111111
11111111 1111111 1111111111111111111111111111111111111111111111111111111111111111111111111111111111111111111111111111111111111111111111111111111111111111111111111111111111111111111111111111
