NO ./textures/purple/north.xpm
SO ./textures/purple/south.xpm
WE ./textures/purple/west.xpm
EA ./textures/purple/east.xpm
F 102,50,113
C 135,206,235
1111111111111
1000000000001
10000001N1001
1000000100001
1000000000001
1111111111111
