NO ./textures/test/north_spritex64.xpm
SO ./textures/test/south_spritex64.xpm
WE ./textures/test/west_spritex64.xpm
EA ./textures/test/east_spritex64.xpm
F 220,100,200
C 0,255,0
1111111111111
1000000000001
10000001N1001
1000000100001
1000000000001
1111111111111
